+--+--+--+--+--+--+--+  +--+--+--+--+--+--+--+
|     |           |     |        |     |     |
+  +  +--+--+--+  +  +  +  +--+--+  +  +--+  +
|  |           |  |  |  |        |  |  |     |
+  +--+--+--+  +  +  +  +--+  +  +--+  +  +--+
|  |           |     |        |        |     |
+  +  +--+--+--+--+  +--+--+--+--+--+--+--+  +
|  |     |           |     |     |        |  |
+  +--+  +  +--+--+--+  +  +  +  +  +--+  +  +
|     |  |  |           |     |  |  |        |
+--+  +  +  +  +--+--+--+--+--+  +  +--+--+--+
|     |     |  |  |        |     |           |
+  +--+--+--+  +  +  +  +--+  +--+--+--+--+  +
|     |        |     |  |     |        |  |  |
+--+  +  +  +--+--+  +  +  +--+  +--+  +  +  +
|     |  |  |        |  |     |  |        |  |
+  +--+  +  +--+--+--+  +--+  +  +--+--+  +  +
|  |  |  |  |           |     |  |        |  |
+  +  +  +  +  +--+--+--+  +  +  +  +--+--+  +
|     |  |     |           |     |  |     |  |
+  +--+  +--+  +  +--+--+--+--+--+  +--+  +  +
|     |     |  |     |           |  |     |  |
+--+  +--+  +  +--+  +  +--+--+  +  +  +--+  +
|     |     |  |     |  |     |  |           |
+  +--+  +--+  +  +--+  +  +  +  +--+  +--+--+
|        |     |     |     |  |        |     |
+--+--+--+  +--+--+  +--+--+  +--+--+  +  +  +
|     |     |     |  |     |  |        |  |  |
+  +  +  +--+--+  +  +  +--+  +  +--+--+  +  +
|  |     |           |        |           |  |
+--+--+--+--+--+--+--+  +--+--+--+--+--+--+--+